R 640 480
    11111111111111111111111111111
    1 1 1000000002110000000000001
    11111011000001110000000000001
        1001000000000000000000001
111111111011000001110000000010001
1000000000110000011101111111 1111
11110111111111011100000010001
11110111111111011101010010001
 1000000112121011100000010001
10000000000000000000000010201
1E000000000000001101010010001
10000000000000001101010010001
1100000011012121111121111000111
11112111 1112121 101111010001
11111111 1111111 11111111111